#####################################
# #       #       #     #         # #
# # ##### # ### ##### ### ### ### # #
#       #   # #     #     # # #   # #
##### # ##### ##### ### # # # ##### #
#   # #       #     # # # # #     # #
# # ####### # # ##### ### # ##### # #
# #       # # #   #     #     #   # #
# ####### ### ### # ### ##### # ### #
#     #   # #S  # #   #     # #     #
# ### ### # ### # ##### # # # #######
#   #   # # #   #   #   # # #   #   #
####### # # # ##### # ### # ### ### #
#     # #     #   # #   # #  X#     #
# ### # ##### ### # ### ### ####### #
# #   #     #     #   # # #       # #
# # ##### # ### ##### # # ####### # #
# #     # # # # #     #       # #   #
# ##### # # # ### ##### ##### # #####
# #   # # #     #     # #   #       #
# # ### ### ### ##### ### # ##### # #
# #         #     #       #       # #
#####################################
